XXXXXXXXXXXXXXXXXXXXXXXX
XXXXXXXXXXXXXXXXXXXXXXXX
XXXXXXXXXXXXXXXXXXXXXXXX
XXXXXXXXXXXXXXXXXXXXXXXX
XXXXXXXXXXXXXXXWPEEEXXXX
XXXXCCCXWPWPWPWPXEEEXXXX
XXXXCCCXPWPWPWPWXEEEXXXX
XXXXCCCXWPWPWPWPXEEEXXXX
XXXXCCCXPWPWPWPWXEEEXXXX
XXXXCCCXWPWPWPWPXEEEXXXX
XXXXCCCWPXXXXXXXXXXXXXXX
XXXXXXXXXXXXXXXXXXXXXXXX
XXXXXXXXXXXXXXXXXXXXXXXX
XXXXXXXXXXXXXXXXXXXXXXXX
XXXXXXXXXXXXXXXXXXXXXXXX